055555555555550
050000050000050
050000050000050
050000050000050
050000000000050
050010000020050
050000000000050
050000050000050
050000050000050
050000050000050
055555555555550
000000000000000