055555555555550
0500P0054000050
050000050000050
050100050055550
055550050000050
050000050000050
050000055550050
050055550300050
050000050000050
0500002500P0050
055555555555550
000000000000000