055555555555550
050000050000050
050000050000050
050000050000050
050000050000050
050000010020050
050000050000050
050000050000050
050000050000050
050000050000050
055555555555550
000000000000000