055555555555550
050000050000050
050000050000050
050000050000050
050000000000050
050000000020050
050010000000050
050000050000050
050010050000050
050000050010050
055555555555550
000000000000000